R 1000 1000 
NO ./xpm/aln.xpm
SO./xpm/als.xpm
WE ./xpm/al.xpm

EA ./xpm/alw.xpm

S  xpm/pupier.xpm

F 220,220,244
C 145,165,200


11111111111111111111111111111111111111111111111111111111111111111111111
10000000000000000000000000000000000000000000000000000000000000000000001
10000000000000000000000000000000000000000000000000000000000000000000001
10000000000000000000000000000000000000000000000000000000000000000000001
10000000002000000001111111010000010111111101111110000000000000000000001
10000000000000000000001000010000010100000001000001000000000000000000001
10000000000000000000001000010000010100000001000001000000000000000000001
10000000000000000000001000010000010111110001111110000000000000000000001
10000000000000000000001000010000010100000001000100000000000000000000001
10000000000000000000001000010000010100000001000010000000000000000000001
100000000000020000000010000011111021111111010000010000000N0000000000001
1000000000000000000000000000000000000002000000000000000000000000000001
1000000020000000000000000000000002000000220000000000000200000000000001
10000000000000000002000000000000000000002000000000000000000000000000001
10001000001000010000111111001111111010000010011111001111111000010000001
10001100011000101000100000101000001010000010100000100001000000101000001
10001010101001000100100000101000001010000010100000000001000001000100001
10001001001010000010111111001000001010000010011111000001000010000010001
10001000001011111110100010001000001010000010000000100001000011111110001
10001000001010000010100001001000001010000010100000100001000010000010001
10001000001010000010100000101111111001111100011111000001000010000010001
10000000000000000000000000000000000000000000000000000000000000000000001
10000000000000000000000000000000000000000000000000000000000000000000001
10000000000000000000000000000000000000000000000000000000000000000000001
11111111111111111111111111111111111111111111111111111111111111111111111