R 1500 1000
NO ./xpm/aln.xpm
SO ./xpm/als.xpm
WE ./xpm/al.xpm
EA ./xpm/alw.xpm

S ./xpm/pupier.xpm

F 220,220,   220
C 145,165,200


111111111            11111111111          1111111111111111111111111111
100000001            10000000001          1000000000002000000000000000111111111111
10010000111        11100000000001111      1000000000000000000000000000000000000001111111
101110000111      10000000003000010011   110000000000000000000000000000000000000000000001
10111000000111   110000000000000010001111000000000000000000000000000000000000000000000001
10000000000001111100000000112110010001000000000000000000000000001100000000000000000000001
10000000000000000000000000111110010001000001100000000000000000001100000000000000000000001
10000000000000000111111110001000010001000001100000000000000000001100000000000000000000001
10111111111111111100000011000000010001001001100000000000000000001100000000000000000000001
10000000000000000000100001111000010001001001100000000000000001001100100000000000003000001
10000001000001111100100000001111110001001001100000000000000001101101100000000000000000001
10000001000001000100100000000000010001001001100000000000000000111111000000000000000000001
10000001000001020100100000111100000001001001100000000000000000011110000000000000000000001
10000001000001000100111100100100010001001000110000000000000000001100000000000000000000001
10000001000001101100000000111100010001001000110000000000000000222222000000000000000000001
10000001111100000000000000000000010001001001111111111111111111111111111111111111111111111
10000000000000000000000000000000010000001000000000000000000000000000000000000000000000001
10030000000002000000000000000000010001111111111111111111111111111111111111111100000000001
10000000000000000000000000000000010001000000000000001000000000000000000000000000000000001
1000000000000000000000000000000001000100N000000200001000000000000000000000000000001000001
10000000000000000000000000000000010001111111111100301000000000000000000000000000001110001
10000111111111111111111111100000010000000000000110001000001111111111111111111111111000111
10000100100010000010000000100000010011111111110010001100000000000000000000000000001110001
10000100001000010000100000100000010000000000000010000100000000000000000000000020001000111
10000100011111111111110000100000011111111111100010000100000000000000000000000000001110001
10000100010000000020010000100000010000000000000010001111111111111111111111111100001000111
10000100010001111111110000100000000111111111111110000000000000000000000000000000001110001
10000100010000000000000000100000000100000000000010011111111000000000000000000000001000111
10000100011111111111111111101000000110000111111010000000001000000000000001111111111110001
10000100000000000000000000000100000000100000001010000000201000111111111111100000000000001
10000111111111111111111111001100000001110000001010000000001000000000000001100000110000001
10000000000000000000000000000000000010101000001011111111101000000000000001100000110000001
10000000000000000000000000000000000000100000001010000000100000000000000001100011111100001
10000000000000000000000000000000000000100000011010000000111110111111100001100011111100001
11111111111110000000000000000000000000100000110010000000000010100000000001100011111100001
10010000000000000000000000000000000000000011100011111111100010100011111111100000000000001
10010001111000001111000000000000000000000010000010000000000110100010000001100000000011001
10000001101100011011000001110000000000000010000010011111111110000011111001100030000110001
10010001100110110011000011011000000000000010011110000000000011000000000001110000001100001
10010001100011100011000111001100000000000010010011111111111000111111100111111110001100001
10010001100000000011011100000000000000000010010000001111000000001111000011000100110000001
10010001100101000011111000111111100000000010010011100000000110001111000001000101100010101
10010001100101003000000000000000110000000010010010001111000110001111111101110111000011101
10010001100101000011000011110000011000000010000010111111000000001111120000010000000001001
11111111110111111111111111111111111111111111111111111111111111111111111111111111111111111
         1001
         1001
         1201
         1111